^^^^^^^^^^^^^^^^^^^^^^^^^^^^^^^^^^^^^^^^^^^^^
*******************************************=
**********D************D************D******=
**********D************D************D******=
**********D************D************D******=
**********D************D************D******=
S****************************************G*=
=^^^^^^^^^^^^^^^^^^^^^^^^^^^^^^^^^^^^^^^^===